0000077700000000000000000000000000000000000000000000000000000000000000003000000000000030000000000000
0000000000000000000000000000000000000000000000000000000007000000000003030000000000000330000000700000
0000000000000000000000000300000000000000000000000000007000000300000000300000070030303000700000000070
0000000000000000000000000030000330000000000000000000770000000300030030300000003333333030000000000000
0000300037333333333330030003300033300330000000000700773330333333330333333333333333333333333333000000
0000003304722222222233333333333333003333000370077337333303333333333333333333133333333330337333300300
0000333333373033333222222222233330333333330000733337300300303330303333337333333343333333333333303030
0000330333337033333733300303222222222222303030003773300330033333333030333333333333333333333330330000
0000303133033077777330333333333333333332233333333333000033333333330333333443303330330333333333333333
0000330333303733004333303473330333333333223338333333333332222222222222222200033333333033373333330000
0000333333030000335333333333333333733333322222222222222222333333333333333400003333333333333303330000
0000000000003333333300003033303003333333333332333333333333333333333333333333000033333333333333333040
0000003333333333300004303330333333333333333332333333333333333333330303303330400337333333333333330000
0000000033333333300033333300033033303333333332333333333033033733330333333330000003333373333343300700
0000003333333334333033333333333333033333333332230330033333033330000333331300070703333333333733000000
0000033333333333333333333330000003333333333333222333003030303300000303333307000000333333303333330000
0000333333333333333333000000333333333333333333332233300330333000000033330000004000003033333333330330
0000031333333333313000033333333330033333337333333233333333330000000000330700000410703333331333333000
0000000000000000000003333333333333303333333333333233333333333333033333330040077000000333443333330000
0000000000070003333333333333733333303333333333333233333333333330330333330701077740000334333333333000
0000000000000000000033333333333373303333333334333233343333337333333333330000047400703333333330000300
0000000000000000000000003333333333300000333333333233333333333333333330333070000000003333313333333000
0000000333333333333333333333333333333333033333332233333333333333330303333300400070037333333330330000
0000333333333333333333322222222222333333333333322333333333433333333333333330070000333333333333330000
0000333333333134333333323333333332223333333333223333733433433333333333333330000033333333334333333000
0000033333333333333333323333333333322233333312233333333333333373333333333333333333303343333333333000
0000333333333333333333323337303333333222222222333333333333333333333333300033330333333343343333430300
0000333333373333343333323333333333333333333332222222333333333333333333300000033333333333373333333003
0000333333333333333333323333333333333333333333333332222222222222223333300333333333337333333333330030
0033333333333333333333121333333333333333333333333333333333333333322233333373337330333333333333330000
0333333333333333333333111333333333333373333333433333333333333333333223333333333333333333304303330000
3300333333333333334444444444333003033333333333333337333333333333033323333333333333333333333333300003
3300333333333333334909009094333333333330333033333333333033033303333322333733333733333333333333307000
3000333033733333334000000004333003033333333333333333333330300000303332333330333333333334333333000300
0000000333333333334909009094333333303333033333333333333333033333333332333333333333373333333333000030
0000003333333333334444444444333333333333333333333333333333333333333332333333333333337733334000033300
0000333333333333333333333333333333333333333377777033333333333333333332333333333333333333330000000030
0000333333330333333333333333333733333333377777730033333330330303033332333333333333333333333333030000
0000333333333333333333333303033333033333333337777333333330000303303332333333333333333333333333330000
0003333333333333333333333333333333333333333777733333333333003033333322333331373333333731330000030000
0003333333333033333333333333333333313333333333333333303333333333333223333333333333333333333033300000
0000333333333333333333333373333333330333333333333343333333333033332233333333333333332433333333330000
0000033333333333373333333333333000003333337331333330033300033333322222222222222222222233333330300300
0000303333333330333333333333333000300033333333333333333333033332223333333333333333334233343330000030
0000330333333333333333333333333000100033333333330030033333333322333333333334333333333333333333330000
7000333333343333333433333333331003000333300033030000031333333223333333333333331333437333333333330000
7700377333333333300333333033333030003333303000030030333333332234333433334334333333333334333333333300
7777773333333333000337330333333003333333300003000000033333332333333333333333337333333333333333300300
7077733337333333330333303373333333333333330333333003333333332433433334333333333343333333337333300300
0077333333333330330033303333333333330333333333333332222222222222222222222333333333333333333333000000
0000333333333333330303300333333333333333333332222222333133338343341343332222222222222322244433330000
0000333333333333333300000033333033333333322222333333333333333333333333333333333333332225243433333000
0030433333333333313333300037333333333322223333333333333333333333373333333333333333333322244433330070
0333333333373333333333300033330333332223333333333333333733333333333333333333333333333333333334300000
0003333333333333333333300033003333332333333333333303333333333333333333333333333333333333333433300000
0000343333337333433337333300333333322222333333333333333373333333333333333333333133333333333333330000
0040333333333333333333333333333332223332222333333333333333333333333333333333333133333733333333333000
0000333433133333133333333333333332333333332222233333333333333333333333333333333333333333333343330030
0003333333333333333333430033332222333333333333222222222333333333333333333373331333333334333333330030
0000333333334333333333330222222333313330033333333333332222222222222333333333333333333337333300330330
0000333333333333333433333333333333333333433333333333333333333333332222222333333333333433333333333000
0000333333333333333333333333333333333337330333333333733343333333333333332222222333333333333333333000
0010333333337773333333433333333333333333333333333333333333333333333333333333332223333333333133333000
0000333313333337733333333333033733333333333333333333333333333333333333333333333322322333333333030001
0000033333337777777333330333333333333333333333733333333733333333333333333333333332222233733333330300
0000333333333333377773333333333333733333333333333333333333333433337333333333333333322333333333330000
0000333333333333333773333333333333333333333333333333333333333333333333333313373333133333333333330003
0000033333333330333333333333333333333333333333333333330000000000000000003333333333333333333333000300
0000000333333333333333033333333333333333333300000000003333333333333333330000000000033331333300333000
0000330033303333333333333333333333000000000033333333333333333333333333333333333333300000330033333040
0000333003333333333333333333333330333333333333333333333333333333333333333333333333333333003333330300
0000333300033333373333333333330003333333333333333333333333333333333333333333333333333333333343330000
0000333330330333333333333330003333333333333333000000000000000000003333333333333333333333333033300000
0000333333333333333333333003333333333333330000000000000000000000000003334333333133343333433033330000
0100333333333333333333000333333333333333000000000000000000004000000000003333333333333333333033303000
0000333330303333033000300303333333333000033333333333333333333333333333330000333333333333330333300300
0000333333333033303330000333333333300333333333333333333333333333333333133331003333333334303300000300
0000033033333333333333000033733330033333333300000000000000000000000033333333330000333333330000000030
7000333333337333333331333333333333333333000003333333333333333333333300033333343333000333330003000030
0000003003333330303333300333333333333330033333334443333333333433333333300003333333377777000033000000
0000330333333333303333333333333303333003333333334543333333333333333333333333000337777000000330003030
0000000333333333333333133333333773333000000333333444333333330000003333333333333777000004003300000000
0000333333301330333303333333333703333333330000003333330000033333300003133333337770000000000300330030
0007333333333333303333333333337733333333333333330000003333333333333333333333377000000077773333330000
0000333333333033333333333330077777777733333333333333333333333333333333333377777010007777777777030000
0000333333333333333333333333370000000777777777777733333333333133333333333070000000007333333777703300
0010333337333333333333333303377000000000000000077777777777777773333433330070000000007331333333700000
0003333333333733307333403333377777777777777000000004000000000777777333333077001000077333303333700330
0003333033333333333033337333370077000000000010000000000000000000077777733307000000077333303333700300
0040300041333333333333333033370000004000000000077777777777000000000000773377000000773333330333700030
0000010100333303033333333333370040007777000000000000000077777777000100077770000000733337773000700000
0000770770334333333330333333377000777770000000000000100000000007700000000000000040777333377330000000
0000700070333333303373330333337700000000001000000000000000000000700000000000000004007777337777777000
3300009000303333333330333330333770000000000000000000000000000000770000000000000000000007733373337730
0330700070333303333033303304333477777777777777777777777777777777777777777777777777777700777773433770
0000770770333334333433343333333770040000000010040000000001000000400000000000044004004000774433340477
0000000000703300003000000300307700000000004000000004004000000040000004004100000000400007700003000000
0043000000033000400373000030007700777777777777777777777777777777777777777777777777777777100300006030
0000000000000100000000004000007740010000000400000000000000400000000000000400000000000000403000100400
0000000000000000000000000003000700000004000000000000400000001000000040000000000100004000000000000000
